wwwwwwwwwwwwwwwwwwwwwwwwwwwwwwwwwwwwwwwwwwwww
w-m---------------------------------------m-w
w-------------------------------------------w
w-------------------------------------------w
w-------------------------------------------w
w--------------------m----------------------w
w-------------------------------------------w
w-------------------------------------------w
w-------------------------------------------w
w-------------------t-p---------------------w
w-------------------------------------------w
w-------------------------------------------w
w-------------------------------------------w
w-------------------------------------------w
w-------------------------------------------w
w-------------------------------------------w
w-------------------------------------------w
w-------------------------------------------w
w-m---------------------------------------m-w
wwwwwwwwwwwwwwwwwwwwwwwwwwwwwwwwwwwwwwwwwwwww
