wwwwwwwwwwwwwwwwwwwwwwwwwwwwwwwwwwwwwwwwwwwww
w-------------------------------------------w
w-------------------------------------------w
w-------------------------------------------w
w------------------www----------------------w
w-------------------------------------------w
w-------------------------------------------w
w-------------h-------s---------------------w
w-------------------------------------------w
w-------------------t-p---------------------w
w-------------------------------------------w
w-----ww------------------------------------w
w-----ww------------------------------------w
w-------------------------------------------w
w-------------------------------------------w
w------------------------w-www--------------w
w------------------------w---w--------------w
w------------------------wwwww--------------w
w-------------------------------------------w
wwwwwwwwwwwwwwwwwwwwwwwwwwwwwwwwwwwwwwwwwwwww
